111111111111111111111111111111
100000000000000000000000000001
100900000000000000000000000001
100000000000000000000000000001
100000000000000000000000000001
100000222000000000000222000001
103330000000000000000000000001
102220000022201102220000022201
100000000000001100000333000001
100000222000001100000222000001
100000000033301103330000000001
102220000022201102220000022201
100000000000001100000000000001
100000222000001100000222000001
100000000000001100000000000001
102220000022201102220000022201
100000000000001100800000008001
100900000000000000000000000001
111111111111111133333333333331
111111111111111111111111111111