111111111111111111111111111111
100000000000000000000000000001
100000000000000000000000000001
100000000000000000000000000001
100000000000000000000000000001
100000000000000000000000000001
100000000000000000000000000001
100000000000000000000000000001
100000000000000000000000000001
100000000000000000000000000801
100000000000000000000000002221
100000002222111100000000000001
100000000000111100000000000001
100000000000111100000000022221
100000002222111100000000000001
100000000000111100000000000001
100900000000000000000000222221
111111111111111100000000000001
111111111111111133333333333331
111111111111111111111111111111