111111111111111111111111111111
100000000000000000000000000001
100000000000000000000000000001
100000000000000000000000000001
100000000000000000000000000001
100000000000000000000000000001
100000000000000000000000000001
100000000000000000000000000001
100000000000000000000000000001
100000000000000000000000000001
100000000000000000000000000001
100000000000000000000000000001
100800000000000000000000000001
111111000000000000000000000001
111111000000009000000000000001
111111000001111111100000000001
111111000001111111100000008001
111111000001111111100000111111
111111333331111111133333111111
111111111111111111111111111111