111111111111111111111111111111
100000000000000000000000055551
100000000000000000000000055551
100000000000000000000000055551
100000000000000000000000055551
100000000000000000000000055551
109000000000000000000000055551
111111111111111111111112211111
111111111111111111111110011111
111111111111111111111114011111
111111111111111111111112211111
111111111111111111111110011111
111111111111111111111114011111
111111111111111111111112211111
100000000000000000000000011111
100000000000000000000000011111
100000000000000000000000011111
100080000000000000000000011111
101111100011111110001111111111
131111133311111113331111111111