111111111111111111111111111111
100000000000000000000000000001
100000000000000000000000000001
100000000000000000000000000001
100000000000000000000000000001
100000000000000000000000000001
100000000000000000000000000001
100000000000000000000000000001
100000000000000000000000000001
100000000000000000000000000001
100000000000000000000000000001
100000000000000000000000000001
100000000000000000000000000001
100000002222220000000000000001
100000000000000000000000000001
111111111111111000000000000001
100000000000000000000000000001
100000000000000000001111111111
100000000000000000001111111111
111111111111111111111111111111
