111111111111111111111111111111
100000000000000000000000000001
100000000000000000000000000001
100000000000000000000000000001
100000000000000000000000000001
100000000000000000000000000001
100000000000000000000000000001
100000000000000000000000000001
100000000000000000000000000001
100000000000000000000000000001
100000000000000000000000000001
100400000000000000000000000001
122222200022222200000000000001
100000000000000000000000008001
122222200000000000000000111111
100400000000090000000000111111
111111111111111100000000111111
111111111111111100000000111111
111111111111111133333333111111
111111111111111111111111111111