111111111111111111111111111111
100000000000000000000000000001
100000000000000000000000000001
100000000000000000000000000001
100000000000000000000000000001
100000000000000110000000000001
100000000000001110000000000001
100000000000011110000000000001
100000000080111110080000000001
100000110011111111110011000001
122222110011111111110011222221
100000000000000000000000000001
122222000000000000000000222221
100000000000000000000000000001
100000000000000000000000000001
100400000000009000000000004001
111111110011111111110011111111
111111110011111111110011111111
111111113311111111113311111111
111111111111111111111111111111