111111111111111111111111111111
100000000000000000000000000001
100000000000000000000000000001
100000000000000000000000000001
100000000000000000000000000001
100000000000000000000000000001
100000000000000000000000000001
100000002222200000000000000001
100000000000000000000000000001
100000000000000000000000000001
100000222222200000000000000001
100000000000000000000000000001
100000000000000000000000000001
100111111111111222220000000001
100111111111111000000000000011
100000000000000000000000033311
100000000000000222221111111111
100000000000000000001111111111
133330000000000000001111111111
111111111111111111111111111111
