111111111111111111111111111111
100000000000001100000000000001
100000000000001100000000000001
100000000000001100000000000001
100000000000001100000000000001
100000000000001100000000000001
100000000000001100000000000001
100000000000001100000000000001
100000000000001100000000000001
100000000000001100000000000001
100000000000001100000000000001
100000000000001100000000000001
100000000000001100000000000001
100000000000001100000000000001
100000000000001100000000000001
100000000000001100000000000001
100000000000001100000000000001
100000000000001100000000000001
109000000008001100800000040001
111111111111111111111111111111