111111111111111111111111111111
100000000000000000000000000001
100000000000000000000000000001
100000000000000000000000000001
100000000000000000000000000001
100000000000000000000000000001
100000000000000000000000000001
100000000000000000000000000001
100000000000000000000000000001
100000000000000000000000000001
100000000000000000000000000001
100400000000000000000000000001
122222200022222200000000000001
100000000000000000000000008001
122220000000000000000001111111
100400000000090000000001111111
111111111111111100000001111111
111111111111111100000001111111
111111111111111133333331111111
111111111111111111111111111111