111111111111111111111111111111
100000000000000000000000000001
100000000000000000000000000001
100000000000000000000000000001
100000000000000000000000000001
100000000000000000000000000001
100000000000000000000000000001
122222111111111111111111000001
100000111111111111111111000001
100000110000000000000011000001
122222110000000000000011000001
100000110000000000000011000001
100000110000066660000011000001
122222110000066660000011000001
100000110000066660000011800081
100900000080066660040000000001
166666110222211112222011000001
166666110000011110000011000001
133333110000011110000011333331
111111111111111111111111111111