111111111111111111111111111111
100000000066000550006600055001
100000000066000550006600055001
100000000066000550006600055001
100000000066000550006600055001
100000000066000550006600055001
109000004066000550006600055001
111111111111111111111122211111
111111111111111111111100011111
111111111111111111111104011111
111111111111111111111122211111
111111111111111111111100011111
111111111111111111111104011111
111111111111111111111122211111
111111111111111111111100011111
111111111111111111111104011111
111111111111111111111122211111
111111111111111111111100011111
111111111111111111111108011111
111111111111111111111111111111