111111111111111111111111111111
140004000400040004000400040001
166406640664066406640664066401
166666666666666666666666666661
100660066006600660066006600661
100000000000000000000000000001
100000000000000000000000000001
100000000000000000000000000001
100000000000000000000000000001
100000000000000000000000000001
100000000000000000000000000001
100900000000000000000000000001
111111111111111111111111111111
111111111111111111111111111111
100010101000111111000101010011
110110101011111111011100010101
110110001001111111001100010101
110110101011111111011101010101
110110101000111111000101010011
111111111111111111111111111111