111111111111111111111111111111
100000000000000000000000000001
100000000000000000000000000001
100000000000000000000000000001
100000000000000000000000000001
100000000000000000000000000001
100000000000000000000000000001
100000000000000000000000000001
100000000000000000000000000001
100000000000000000000000000001
100900000000000000008000000001
111111111111111111222221111111
111111111111111111000001111111
111111111111111111000001111111
111111111111111111000001111111
111111111111111111000001111111
111111111111111111008001111111
111111111111111111000001111111
111111111111111111333331111111
111111111111111111111111111111