111111111111111111111111111111
100000000000000000000000000001
104004004004004004004004004001
106606606606606606606606606601
106606606606606606606606606601
100000000000000000000000000001
105505505505505505505505505501
105505505505505505505505505501
100000000000000000000000000001
106606606606606606606606606601
106606606606606606606606606601
100000000000000000000000000001
100000000000000000000000000001
100000000000000000000000000001
100000000000000000000000000001
100006666000000000000000000001
100006666000000000000000000001
100000000000000000000000066661
100900000000000000000000066661
111111111111111111111111111111