111111111111111111111111111111
100000000000000000000000000001
100000000000000000000000000001
100000000000000000000000000001
100000000000000000000000000001
109000000000000000000000000001
111110001110000000000000000001
111110801110001110000000000001
111110000000801110000000000001
111110001110000000000800000001
111110001110001110001110000001
111110001110001110001110000001
111110021112001110000000000001
111110000000021112001110000001
111110000000000000001110000801
111110000000000000001110001111
111110000000000000021112001111
111110000000000000000000000001
111110000000000000000000001111
111111111111111111111111111111