111111111111111111111111111111
100000000000000001111111111111
100000000000000001111111111111
100000000000000001111111111111
100000000000000001111111111111
100000000000000001111111111111
100000000000000001111111111111
100000000000000001111111111111
100000222111100001111000000001
100000000111100001111000000001
100000000111100001111000000001
100000222111100001111000000001
100000000111100001111000000001
100000000111100001111000000001
100000222111100000000000000001
100000000111100000000000008001
100900000004000001111111111111
111111111111100001111111111111
111111111111133331111111111111
111111111111111111111111111111