111111111111111111111111111111
100000000000000000000000000001
100000000000000000000000000001
100000000000000000000000000001
100000000000000000000000000001
100000000000000000000000000001
100000000000000000000000000001
122222111111111111111111000001
100000111111111111111111000001
100000110000000000000011000001
122222110000000000000011000001
100000110000000000000011000001
100000110000000000000011000001
122222110000000000000011000001
100000110000006600000011800081
100900000080006600040000000001
166666110222221122222011000001
166666110000001100000011000001
133333110000001100000011333331
111111111111111111111111111111