111111111111111111111111111111
155556666000000001111000000001
155556666000000001111000000001
155556666000000001111000000001
155556666000000001111000000401
155550000000000000000666611111
155550000000000000000666611111
155550000000000000000666611111
155550800000000400000666611111
166665555111166665555555500001
166665555111166665555555500001
166665555111166665555555500001
166665555111166665555555500801
111111111111111111111111111111
111111111111111111111111111111
100000000000000000000000000001
100000900000000000000000000001
100000000000000000000000000001
100900000000000000000000000001
111111111111111111111111111111